111111111111111111111111111111111
100200000000000000000000000000001
101010101010101010101010101010101
100200202000000000000000000000001
101010121010101010101010101010101
100200000000000000000000000000001
101010101010101010101010101010101
100200000000000000000000000000001
101010101010101010101010101010101
100000000000000000000000000000001
101010101010101010101010101010101
100000000000000000000000000000001
101010101010101010101010101010101
100000000000000000000000000000001
101010101010101010101010101010101
100000000000000000000000000000001
101010101010101010101010101010101
100000000000000000000000000000001
101010101010101010101010101010101
100000000000000000000000000000001
101010101010101010101010101010101
100000000000000000000000000000001
101010101010101010101010101010101
100000000000000000000000000000001
111111111111111111111111111111111