111111111111111111111111111111111
100000000000000000000000000000001
101010101010101010101010101010101
100000000020000000002000000000001
101010101010101010101010101010101
100000000000000000000000000000001
101010101010101010101010101010101
100000000000000000000000000000001
101010101010101010101010101010101
100000000000000000000000000000001
101010101010101010101010101010101
100000000000000200000000000000001
101010101010101010101010101010101
100000000000000000000000000000001
101010101010101010101010101010101
100000000000000000000000000000001
101010101010101010101010101010101
100000000000002000000000000000001
101010101010101010101010101010101
100000000000000000000000000000001
101010101010101010101010101010101
100000002000000000000000000000001
101210101010101010101010101010101
100000000000000000000000000000001
111111111111111111111111111111111
