111111111111111111111111111111111
100200000000020000000200000200001
101010101010101010101010101010101
100200202000020000002000020020001
101010121010101010101010101010101
100200020000000200000000000000001
101010101010101010101010101010101
100200000002000002000000020020001
101010101010101010101010101010101
100002000000200002000200000000001
101010101010101010101010101010101
100002000020000002000000222000001
101010101010101010101010101010101
100000200200000000000000000000001
101210101210101012101010121010101
100000002000000020000000000000001
101010101010101010101010101010101
100000000000000000000000020000001
101210101010101010101210101010101
100000000000200002000000200000001
101010101010101010101012101010101
100200000002000000020000000000001
101010101010101010101010101010101
100200000000200000000002000000001
111111111111111111111111111111111